WWWWWWWWWWWWWWWWWWWW
WKKEEEEEEWEEKKEEEKEW
WEEEEEEEEWEEEEEEEEEW
WEEELLEEEWEEOOEEEWWW
WEEEEEEEEEEEEEEEEEEW
WEEEWWWWWWEEEKKEEEEW
WELEWEEEEWWWWWLLWWEW
WEEEOEEEEWEKEWEEEEEW
WSEEWEEOELEKEWEEEWWW
WWWWWWWWWWWWWWWWWWWW

WWWWWWWWWWWWWWWWWWWW
WYYEEEEEEWEEGGEEEBEW
WEEEEEEEEWEEEEEEEEEW
WEEELLEEEWEERBEEEWWW
WEEEEEEEEEEEEEEEEEEW
WEEEWWWWWWEEERREEEEW
WELEWEEEEWWWWWLLWWEW
WEEEREEEEWEREWEEEEEW
WEEEWEEGELEGEWEEEWWW
WWWWWWWWWWWWWWWWWWWW