WWWWWWWWWW
WEEEWESEEW
WEEEOEEEEW
WEWWWEWWWW
WEEKEEELLW
WEEEEEEWWW
WEEKEEEEEW
WEEKEEEEEW
WEEEEEOOEW
WWWWWWWWWW

WWWWWWWWWW
WEEEWESEEW
WEEEYEEEEW
WEWWWEWWWW
WEEREEELLW
WEEEEEEWWW
WEEREEEEEW
WEEBEEEEEW
WEEEEERBEW
WWWWWWWWWW
