WWWWWWWWWW
WLLLEEEESW
WEEEKKEEEW
WWWEEEEEEW
WEEEEKKEEW
WEEEEEEEEW
WEEOEEEEWW
WEEOELEEOW
WEEOLEEEOW
WWWWWWWWWW

WWWWWWWWWW
WLLLEEEEEW
WEEEBBEEEW
WWWEEEEEEW
WEEEEGGEEW
WEEEEEEEEW
WEEGEEEEWW
WEEBELEEBW
WEERLEEERW
WWWWWWWWWW