WWWWWWWWWW
WEEEEEEESW
WEEEEEEEEW
WEEEEEEWWW
WEEEEEEEEW
WWWWWWWWOW
WEEEEEEEEW
WEEEEEEWWW
WEEEEEEEEW
WWWWWWWWWW

WWWWWWWWWW
WEEEEEEESW
WEEEEEEEEW
WEEEEEEWWW
WEEEEEEEEW
WWWWWWWWYW
WEEEEEEEEW
WEEEEEEWWW
WEEEEEEEEW
WWWWWWWWWW
