WWWWWWWWWWWWWWWWWWWW
WLLLEEEEEEWLEEEELLEW
WEEEKKEEEEWLEEEEEEEW
WWWEEEEEEEWWEEEEOOEW
WEEEEKKEEEWEEEEEEEEW
WEEEEEEEEEWWEEEEKKKW
WEEOEEEEWOWWEEEEEEEW
WEEOELEEOEEEEEEWWWWW
WEEOLEEEOEEELLEEEEEW
WWWWWWWWWWWWWWWWWWWW

WWWWWWWWWWWWWWWWWWWW
WLLLEEEEEEWLEEEELLEW
WEEEBBEEEEWLEEEEEEEW
WWWEEEEEEEWWEEEERBEW
WEEEEGGEEEWEEEEEEEEW
WEEEEEEEEEWWEEEEYYBW
WEEGEEEEWGWWEEEEEEEW
WEEBELEEBEEEEEEWWWWW
WEERLEEEREEELLEEEEEW
WWWWWWWWWWWWWWWWWWWW