WWWWWWWWWWWWWWWWWWWW
WEEEEEEWWWWWWWEEEEEW
WEWWEEEWEEEEELLEEEEW
WLLLOOWWWEEKKEEEEEEW
WEKKEEEEEOEEWWEEEEEW
WEEEEKEEWEEWWWEEEEEW
WEEEKEELEEEEWWEELLEW
WEKKEEELEEOEEEEEEEEW
WLLESEEWEEOEEEKKEKEW
WWWWWWWWWWWWWWWWWWWW

WWWWWWWWWWWWWWWWWWWW
WEEEEEEWWWWWWWEEEEEW
WEWWEEEWEEEEELLEEEEW
WLLLRRWWWEERBEEEEEEW
WEYGEEEEEGEEWWEEEEEW
WEEEEYEEWEEWWWEEEEEW
WEEEYEELEEEEWWEELLEW
WEGBEEELEEGEEEEEEEEW
WLLEEEEWEEGEEEYREYEW
WWWWWWWWWWWWWWWWWWWW