WWWWWWWWWW
WEEEEEEESW
WEEEEEEEEW
WEEEEEEEEW
WEEEEEEEEW
WWWWEWWWWW
WEEEEEEEEW
WEEEEEEEEW
WEEEEEEEEW
WWWWWWWWWW

WWWWWWWWWW
WEEEEEEEEW
WEEEEEEEEW
WEEEEEEEEW
WEEEEEEEEW
WWWWEWWWWW
WEEEEEEEEW
WEEEEEEEEW
WEEEEEEEEW
WWWWWWWWWW