WWWWWWWWWW
WLEEEELLSW
WLEEEEEEEW
WWEEEEOOEW
WEEEEEEEEW
WWEEEEKKKW
WWEEEEEEEW
WEEEEWWWWW
WELLEEEEEW
WWWWWWWWWW

WWWWWWWWWW
WLEEEELLEW
WLEEEEEEEW
WWEEEERBEW
WEEEEEEEEW
WWEEEEYYBW
WWEEEEEEEW
WEEEEWWWWW
WELLEEEEEW
WWWWWWWWWW