WWWWWWWWWWWWWWWWWWWW
WEEEEEEEEEEEEEEEEESW
WEEEEEEEEEEEEEEEEEEW
WEEEEEEEEEEEEEEEEWWW
WEEEEEEEEEEEEEEEEEEW
WWWWWWWWWWWWWWWWWWOW
WEEEEEEEEEEEEEEEEEEW
WEEEEEEEEEEEEEEEEWWW
WEEEEEEEEEEEEEEEEEEW
WWWWWWWWWWWWWWWWWWWW

WWWWWWWWWWWWWWWWWWWW
WEEEEEEEEEEEEEEEEESW
WEEEEEEEEEEEEEEEEEEW
WEEEEEEEEEEEEEEEEWWW
WEEEEEEEEEEEEEEEEEEW
WWWWWWWWWWWWWWWWWWYW
WEEEEEEEEEEEEEEEEEEW
WEEEEEEEEEEEEEEEEWWW
WEEEEEEEEEEEEEEEEEEW
WWWWWWWWWWWWWWWWWWWW