WWWWWWWWWWWWWWWWWWWW
WEEEEEEOEWEEEEWEEEEW
WEEEEEWEEEEEEEWEEEEW
WEEEEEWWWWWWWWWEEEEW
WEEEWWWEEEEEEEOEEEEW
WEEEEEWEEEWWWWWWWWOW
WEEEEEWEEEEEEWEEEEEW
WEEEEEWEEEEEEWEEEEEW
WEEEEEOEEEEEEWEEEEEW
WWWWWWWWWWWWWWWWWWWW

WWWWWWWWWWWWWWWWWWWW
WEEEEEEYEWEEEEWEEEEW
WEEEEEWEEEEEEEWEEEEW
WEEEEEWWWWWWWWWEEEEW
WEEEWWWEEEEEEEYEEEEW
WEEEEEWEEEWWWWWWWWYW
WEEEEEWEEEEEEWEEEEEW
WEEEEEWEEEEEEWEEEEEW
WEEEEEYEEEEEEWEEEESW
WWWWWWWWWWWWWWWWWWWW