WWWWWWWWWW
WEEEEEEOEW
WEEEEEWEEW
WEEEEEWWWW
WEEEWWWEEW
WEEEEEWEEW
WEEEEEWEEW
WEEEEEWEEW
WSEEEEOEEW
WWWWWWWWWW

WWWWWWWWWW
WEEEEEEYEW
WEEEEEWEEW
WEEEEEWWWW
WEEEWWWEEW
WEEEEEWEEW
WEEEEEWEEW
WEEEEEWEEW
WSEEEEYEEW
WWWWWWWWWW