WWWWWWWWWW
WEEEEEEWWW
WEWWEEEWEW
WLLLOOWWWW
WEKKSEEEEW
WEEEEKEEWW
WEEEKEELEW
WEKKEEELEW
WELEEEEWEW
WWWWWWWWWW

WWWWWWWWWW
WEEEEEEWWW
WEWWEEEWEW
WLLLRRWWWW
WEYGEEEEEW
WEEEEYEEWW
WEEEYEELEW
WEGBEEELEW
WLLEEEEWEW
WWWWWWWWWW