WWWWWWWWWW
WEKKEEEWEW
WEEEEEEWEW
WEOEEWWWEW
WEEESEELEW
WEKKEEEWEW
WEEOEEEWEW
WEEEEWEEEW
WEEEEWWWLW
WWWWWWWWWW

WWWWWWWWWW
WEYGEEEWEW
WEEEEEEWEW
WEBEEWWWEW
WEEEEEELEW
WEGGEEEWEW
WEEGEEEWEW
WEEEEWEEEW
WEEEEWWWLW
WWWWWWWWWW
