WWWWWWWWWW
WKEKOEEKKW
WKEEEEEEEW
WEWWELEEEW
WEWEELEEEW
WEEEELEEEW
WKEOEEEEEW
WEEOEEELLW
WWWWWWWWWW
WWWWWWWWWW

WWWWWWWWWW
WGBGYEEYYW
WREEEEEEEW
WEWWELEEEW
WEWEELEEEW
WEEEELEEEW
WBEBEEEEEW
WEEGEEELLW
WWWWWWWWWW
WWWWWWWWWW
