WWWWWWWWWW
WEEEOEEEOW
WEEEWEEEWW
WWOWWWWWWW
WEEEWEEEWW
WEEEWEEEWW
WEEEEEEEWW
WEEEWEEEWW
WSEEEEEEWW
WWWWWWWWWW

WWWWWWWWWW
WEEEYEEEYW
WEEEWEEEWW
WWYWWWWWWW
WEEEWEEEWW
WEEEWEEEWW
WEEEEEEEWW
WEEEWEEEWW
WEEEEEEEWW
WWWWWWWWWW
