WWWWWWWWWWWWWWWWWWWW
WEEEEEEWWWWWWWEEEELW
WEEEEEEWEEEEEWEEEELW
WWWWOWWWWEEEEWEEEEEW
WEEEEEEEEEEEWWEELEEW
WWWWOWWWWWWWWWEELEEW
WWWWOWWWEEWWWWEELEEW
WEEEEEEWEEEEEEEEEEEW
WSEEEEEWEEOOEEKKEEEW
WWWWWWWWWWWWWWWWWWWW

WWWWWWWWWWWWWWWWWWWW
WEEEEEEWWWWWWWEEEELW
WEEEEEEWEEEEEWEEEELW
WWWWYWWWWEEEEWEEEEEW
WEEEEEEEEEEEWWEELEEW
WWWWYWWWWWWWWWEELEEW
WWWWYWWWEEWWWWEELEEW
WEEEEEEWEEEEEEEEEEEW
WEEEEEEWEEYBEERGEEEW
WWWWWWWWWWWWWWWWWWWW