WWWWWWWWWWWWWWWWWWWW
WEEEOEEEOEEEEEWESEEW
WEEEWEEEWEEEEEOEEEEW
WWOWWWWWWWWWWWWWWWWW
WEEEWEEEWEEEEKEEELLW
WEEEWEEEWEEEEEEEEWWW
WEEEEEEEWELEEKEEEEEW
WEEEWEEEWELEEKEEEEEW
WEEEEEEEOEEEEEEEOOEW
WWWWWWWWWWWWWWWWWWWW

WWWWWWWWWWWWWWWWWWWW
WEEEYEEEYEEEEEWESEEW
WEEEWEEEWEEEEEYEEEEW
WWYWWWWWWWWWWWWWWWWW
WEEEWEEEWEEEEREEELLW
WEEEWEEEWEEEEEEEEWWW
WEEEEEEEWELEEREEEEEW
WEEEWEEEWELEEBEEEEEW
WEEEEEEEREEEEEEERBEW
WWWWWWWWWWWWWWWWWWWW
