WWWWWWWWWW
WWWWEEEEEW
WEELLEEEEW
WKKEEEEEEW
WEWWESEEEW
WWWWEEEEEW
WEWWEELLEW
WEEEEEEEEW
WEEEKKEKEW
WWWWWWWWWW

WWWWWWWWWW
WWWWEEEEEW
WEELLEEEEW
WRBEEEEEEW
WEWWEEEEEW
WWWWEEEEEW
WEWWEELLEW
WEEEEEEEEW
WEEEYREYEW
WWWWWWWWWW