WWWWWWWWWW
WEEEEEEEEW
WEEEWEEEEW
WWWWWEEEEW
WEEEOEEEEW
WWWWWWWWOW
WEEWEEEEEW
WEEWEEEEEW
WEEEEEEESW
WWWWWWWWWW

WWWWWWWWWW
WEEEEEEEEW
WEEEWEEEEW
WWWWWEEEEW
WEEEYEEEEW
WWWWWWWWYW
WEEWEEEEEW
WEEWEEEEEW
WEEEEEEESW
WWWWWWWWWW