WWWWWWWWWWWWWWWWWWWW
WEKKEEEWEEEKEKOEEKKW
WEEEEEEWEEEKEEEEEEEW
WEOEEWWWEEEEWWELEEEW
WEEEEEELEEOEWEELEEEW
WEKKEEEWEEKEEEELEEEW
WEEOEEEWEEKKEOEEEEEW
WEEEEWEEEEEEEOEEELLW
WSEEEWWWLLLWWWWWWWWW
WWWWWWWWWWWWWWWWWWWW

WWWWWWWWWWWWWWWWWWWW
WEYGEEEWEEEGBGYEEYYW
WEEEEEEWEEEREEEEEEEW
WEBEEWWWEEEEWWELEEEW
WEEEEEELEEREWEELEEEW
WEGGEEEWEEYEEEELEEEW
WEEGEEEWEEGBEBEEEEEW
WEEEEWEEEEEEEGEEELLW
WEEEEWWWLLLWWWWWWWWW
WWWWWWWWWWWWWWWWWWWW
