WWWWWWWWWWWWWWWWWWWW
WEKKEEEWEEEKEKOEEKKW
WEEEEEEWEEEKEEEEEEEW
WEOEEWWWEEEEWWELEEEW
WEEEEEELEEOEWEELEEEW
WEKKEEEWEEKEEEELEEEW
WEEOEEEWEEKKEOEEEEEW
WEEEEWEEEEEEEOEEELLW
WEEEEWWWLLLWWWWWWWWW
WEEEEEEEEEEEEEEEEEEW
WWWWWWWWWWWWWOWWWWWW
WEEEEEEOEWEEEEWEEEEW
WEEEEEWEEEEEEEWEEEEW
WEEEEEWWWWWWWWWEEEEW
WEEEWWWEEEEEEEOEEEEW
WEEEEEWEEEWWWWWWWWOW
WEEEEEWEEEEEEWEEEEEW
WEEEEEWEEEEEEWEEEEEW
WEEEEEOEEEEEEWEEEESW
WWWWWWWWWWWWWWWWWWWW

WWWWWWWWWWWWWWWWWWWW
WEYGEEEWEEEGEGBEEYYW
WEEEEEEWEEEREEEEEEEW
WEBEEWWWEEEEWWELEEEW
WEEEEEELEEREWEELEEEW
WEGGEEEWEEYEEEELEEEW
WEEGEEEWEEGBEBEEEEEW
WEEEEWEEEEEEEGEEELLW
WEEEEWWWLLLWWWWWWWWW
WEEEEEEEEEEEEEEEEEEW
WWWWWWWWWWWWWYWWWWWW
WEEEEEEYEWEEEEWEEEEW
WEEEEEWEEEEEEEWEEEEW
WEEEEEWWWWWWWWWEEEEW
WEEEWWWEEEEEEEYEEEEW
WEEEEEWEEEWWWWWWWWYW
WEEEEEWEEEEEEWEEEEEW
WEEEEEWEEEEEEWEEEEEW
WEEEEEYEEEEEEWEEEEEW
WWWWWWWWWWWWWWWWWWWW