WWWWWWWWWWWWWWWWWWWW
WKKEEWEEEEEWEEEEEESW
WEEEEWEEEEEOEEEEEEEW
WEEELWEEEEEWWWWWWWWW
WEOELWEEEEEEEEEEEEEW
WEOELWEEEEEEEEEEEEEW
WEEEEWWWWOWWWWWWWWWW
WEEEEWEEEEEEEEEEEEEW
WEEWWWEEEEEEWWWEEEWW
WEEEEWEEEEEEEWEEEEEW
WWWEEWEEEEEEEEEEEEEW
WEEEEWWWOWWWWWWOWWWW
WEEEEOEEEEEWEEEEELLW
WWWWWWWWEEEWEEEEEEEW
WEEEEWEELLEWEEKEEEEW
WEEEEWEEEEEWEEKEELEW
WEEKKEEEEKEOWWWEELEW
WEEEEEEEEKEOEEEEELEW
WEEELELEEEEWEKKEEEEW
WWWWWWWWWWWWWWWWWWWW

WWWWWWWWWWWWWWWWWWWW
WRGEEWEEEEEWEEEEEESW
WEEEEWEEEEEYEEEEEEEW
WEEELWEEEEEWWWWWWWWW
WEBELWEEEEEEEEEEEEEW
WEBELWEEEEEEEEEEEEEW
WEEEEWWWWYWWWWWWWWWW
WEEEEWEEEEEEEEEEEEEW
WEEWWWEEEEEEWWWEEEWW
WEEEEWEEEEEEEWEEEEEW
WWWEEWEEEEEEEEEEEEEW
WEEEEWWWYWWWWWWYWWWW
WEEEEYEEEEEWEEEEELLW
WWWWWWWWEEEWEEEEEEEW
WEEEEWEELLEWEEBEEEEW
WEEEEWEEEEEWEEBEELEW
WEERREEEEGEBWWWEELEW
WEEEEEEEEREGEEEEELEW
WEEELELEEEEWEGGEEEEW
WWWWWWWWWWWWWWWWWWWW