WWWWWWWWWWWWWWWWWWWW
WEEEEEEWWEEEEEWEEEEW
WEEEEEWWWWWEWWWWEEEW
WWWEEEEEWEEEEEWWWWOW
WEEEEEEEOEEEEEEEEEEW
WEEEEEEEWWWWWWWWWWWW
WOWWWWWWWEEEKKEEEEEW
WEEEEEEEWEEEEEEEEEEW
WEEEEEEEWEEEEWWWWEEW
WWWOWWWWWEEEWWWWEEEW
WEWEEEEEWKEEEEEEEEEW
WEWEEELLWKEEELLLLLLW
WEEEKKEEWEEEEEEEEEEW
WEEOEEEEWWWWWWEEWWWW
WEEEEEEEEEEEEEEEEELW
WWWWWWWLLEEOOEEEEELW
WEEEEEEEEEEEKKKEEEEW
WEEEEWWWEEEEEEEEEEEW
WLLLEEEWEEEEELLLEEEW
WWWWWWWWWWWWWWWWWWWW

WWWWWWWWWWWWWWWWWWWW
WEEEEEEWWEEEEEWEEEEW
WEEEEEWWWWWEWWWWEEEW
WWWEEEEEWEEEEEWWWWYW
WEEEEEEEYEEEEEEEEEEW
WEEEEEEEWWWWWWWWWWWW
WYWWWWWWWEEEYGEEEEEW
WEEEEEEEWEEEEEEEEEEW
WEEEEEEEWEEEEWWWWEEW
WWWYWWWWWEEEWWWWEEEW
WEWEEEEEWREEEEEEEEEW
WEWEEELLWREEELLLLLLW
WEEERGEEWEEEEEEEEEEW
WEEGEEEEWWWWWWEEWWWW
WEEEEEEEEEEEEEEEEELW
WWWWWWWLLEERREEEEELW
WEEEEEEEEEEERGBEEEEW
WEEEEWWWEEEEEEEEEEEW
WLLLEEEWEEEEELLLEEEW
WWWWWWWWWWWWWWWWWWWW