WWWWWWWWWWWWWWWWWWWW
WKKEEEEEEWEEKKEEEKEW
WEEEEEEEEWEEEEEEEEEW
WEEELLEEEWEEOOEEEWWW
WEEEEEEEEEEEEEEEEEEW
WEEEWWWWWWEEEKKEEEEW
WELEWEEEEWWWWWLLWWEW
WEEEOEEEEWEKEWEEEEEW
WEEEWEEOELEKEWEEEWWW
WEEEWEEOELEEEEEKEEEW
WWWOWWWWWWWLLLWWWEWW
WEEEEEEWWWWWWWEEEELW
WEEEEEEWEEEEEWEEEELW
WWWWOWWWWEEEEWEEEEEW
WEEEEEEEEEEEWWEELEEW
WWWWOWWWWWWWWWEELEEW
WWWWOWWWEEWWWWEELEEW
WEEEEEEWEEEEEEEEEEEW
WSEEEEEWEEOOEEKKEEEW
WWWWWWWWWWWWWWWWWWWW

WWWWWWWWWWWWWWWWWWWW
WYYEEEEEEWEEGGEEEBEW
WEEEEEEEEWEEEEEEEEEW
WEEELLEEEWEERBEEEWWW
WEEEEEEEEEEEEEEEEEEW
WEEEWWWWWWEEERREEEEW
WELEWEEEEWWWWWLLWWEW
WEEEREEEEWEREWEEEEEW
WEEEWEEGELEGEWEEEWWW
WEEEWEEBELEEEEEBEEEW
WWWYWWWWWWWLLLWWWEWW
WEEEEEEWWWWWWWEEEELW
WEEEEEEWEEEEEWEEEELW
WWWWYWWWWEEEEWEEEEEW
WEEEEEEEEEEEWWEELEEW
WWWWYWWWWWWWWWEELEEW
WWWWYWWWEEWWWWEELEEW
WEEEEEEWEEEEEEEEEEEW
WEEEEEEWEEYBEERGEEEW
WWWWWWWWWWWWWWWWWWWW