WWWWWWWWWWWWWWWWWWWW
WEEEEEEEEWEEEEEEEESW
WEEEEEEEEWEEEEEEEEEW
WEEEEEEEEWEEEEEEEWWW
WEEEEEEEEOEEEEEEEEEW
WEEEWWEEEWEEEEEEEEEW
WEEEWEEEEWWWWWWWWWOW
WEEEEEEEEWEEEEEEEEEW
WEEEWEEEEWEEEEEEEWWW
WEEEWEEEEWEEEEEEEEEW
WWWOWWWWWWWWWWWWWOWW
WEEEEEEWWWWWWWEEEEEW
WEWWEEEWEEEEELLEEEEW
WLLLOOWWWEEKKEEEEEEW
WEKKEEEEEOEEWWEEEEEW
WEEEEKEEWEEWWWEEEEEW
WEEEKEELEEEEWWEELLEW
WEKKEEELEEOEEEEEEEEW
WLLEEEEWEEOEEEKKEKEW
WWWWWWWWWWWWWWWWWWWW

WWWWWWWWWWWWWWWWWWWW
WEEEEEEEEWEEEEEEEEEW
WEEEEEEEEWEEEEEEEEEW
WEEEEEEEEWEEEEEEEWWW
WEEEEEEEEYEEEEEEEEEW
WEEEWWEEEWEEEEEEEEEW
WEEEWEEEEWWWWWWWWWYW
WEEEEEEEEWEEEEEEEEEW
WEEEWEEEEWEEEEEEEWWW
WEEEWEEEEWEEEEEEEEEW
WWWYWWWWWWWWWWWWWYWW
WEEEEEEWWWWWWWEEEEEW
WEWWEEEWEEEEELLEEEEW
WLLLRRWWWEERBEEEEEEW
WEYGEEEEEGEEWWEEEEEW
WEEEEYEEWEEWWWEEEEEW
WEEEYEELEEEEWWEELLEW
WEGBEEELEEGEEEEEEEEW
WLLEEEEWEEGEEEYREYEW
WWWWWWWWWWWWWWWWWWWW