WWWWWWWWWWWWWWWWWWWW
WWWEEWEEEEWWEEEKKESW
WEEEEWEELEEOEEEEKEEW
WEEEEWEELEEEWWWWLLLW
WEWEEWEEEEEEEEEEEEEW
WEWEEWEEEEEEEEEEEEEW
WEWEEWWWWOWWWWWWWWWW
WEEEEWEEEEEEEEEEEEEW
WEEEEWEEEEEEWWWEEEWW
WELEEOEEEEEEEWEEEEEW
WELEELEEEEEEEEEEEEEW
WEEEELWWWOWWWWWLLWWW
WEEEEWEEEEEWEEEEEEEW
WWWWWWWWEEEWEEEELLEW
WEEKKWEEEEEWEEKEEEEW
WEEEEWEEEEEWEEKEEEEW
WEEWWEEEEEEWWWWEEEEW
WEEEEEEWWEEOEEKEEEEW
WEEEKKEWEEEWEKKEEEEW
WWWWWWWWWWWWWWWWWWWW

WWWWWWWWWWWWWWWWWWWW
WWWEEWEEEEWWEEEYYEEW
WEEEEWEELEEYEEEEYEEW
WEEEEWEELEEEWWWWLLLW
WEWEEWEEEEEEEEEEEEEW
WEWEEWEEEEEEEEEEEEEW
WEWEEWWWWYWWWWWWWWWW
WEEEEWEEEEEEEEEEEEEW
WEEEEWEEEEEEWWWEEEWW
WELEEYEEEEEEEWEEEEEW
WELEELEEEEEEEEEEEEEW
WEEEELWWWYWWWWWLLWWW
WEEEEWEEEEEWEEEEEEEW
WWWWWWWWEEEWEEEELLEW
WEEYYWEEEEEWEEYEEEEW
WEEEEWEEEEEWEEYEEEEW
WEEWWEEEEEEWWWWEEEEW
WEEEEEEWWEEYEEYEEEEW
WEEEYYEWEEEWEYYEEEEW
WWWWWWWWWWWWWWWWWWWW