WWWWWWWWWWWWWWWWWWWW
WEEEOEEEOEEEEEWEEESW
WEEEWEEEWEEEEEOEEEEW
WWOWWWWWWWWWWWWWWWWW
WEEEWEEEWEEEEKEEELLW
WEEEWEEEWEEEEEEEEWWW
WEEEEEEEWELEEKEEEEEW
WEEEWEEEWELEEKEEEEEW
WEEEEEEEWEEEEEEEOOEW
WEEEEEEEOEEEEEEEEEEW
WWWWWWWWWWWWLLOOWWWW
WLLLEEEEEEWLEEEELLEW
WEEEKKEEEEWLEEEEEEEW
WWWEEEEEEEWWEEEEOOEW
WEEEEKKEEEWEEEEEEEEW
WEEEEEEEEEWWEEEEKKKW
WEEOEEEEWOWWEEEEEEEW
WEEOELEEOEEEEEEWWWWW
WEEOLEEEOEEELLEEEEEW
WWWWWWWWWWWWWWWWWWWW

WWWWWWWWWWWWWWWWWWWW
WEEEYEEEYEEEEEWEEEEW
WEEEWEEEWEEEEEYEEEEW
WWYWWWWWWWWWWWWWWWWW
WEEEWEEEWEEEEREEELLW
WEEEWEEEWEEEEEEEEWWW
WEEEEEEEWELEEREEEEEW
WEEEWEEEWELEEBEEEEEW
WEEEEEEEWEEEEEEERBEW
WEEEEEEEREEEEEEEEEEW
WWWWWWWWWWWWLLGGWWWW
WLLLEEEEEEWLEEEELLEW
WEEEBBEEEEWLEEEEEEEW
WWWEEEEEEEWWEEEERBEW
WEEEEGGEEEWEEEEEEEEW
WEEEEEEEEEWWEEEEYYBW
WEEGEEEEWGWWEEEEEEEW
WEEBELEEBEEEEEEWWWWW
WEERLEEEREEELLEEEEEW
WWWWWWWWWWWWWWWWWWWW